...#...#....#....##...###....#.
#.#...#...#....#.........#..#..
.#....##..#.#..##..##..........
.....#.#.............#..#......
.......#...#.##.#......#..#.#..
#.#....#......##........##.....
.....##.#....#..#...#...##...#.
...#...#..#.......#..#...##...#
..........#...........##.......
..#..#..#...................#..
#..#....#.....##.#.#..........#
.#.##.......###.....#.#...#....
.#..##....##....#.......#...###
#.#..##...#.#..#...............
.........#....#.......##.#.#...
...###...##....##...#..##.#..#.
....#.........#..#...#.......#.
....................#..#.#.#...